NO ./ruta_a_la_textura_norte.xpmm
SO ./ruta_a_la_textura_sur.xpm
WE ./ruta_a_la_textura_oeste.xpm
EA ./ruta_a_la_textura_este.xpm

F 220,100,0
C 225,30,000000

        1111111111111111111111111
        1000000000110000000000001
        1011000001110000000000001
        1001000000000000000000001
111111111011000001110000000000001
100000000011000001110111011111111
11110111111111011100000010001
11110111111111011101010010001
11000000110101011100001010001
10000000000000001100N00010001
10000000000000001101010000001
1100000111010101110101111000
11110111 1110101 101111000001
11111111 1111111 111111111111