NO ./res/bookshelf.xpm 
SO ./res/bricksx64.xpm
WE ./res/bookshelf.xpm
EA ./res/bricksx64.xpm

F 0,1,1e0
C 50,-100,25234852

        1111111111111111111111111
        1000000000110000000000001
        1011000001110000000000001
        1000000000000000000000001
111111111011000001110000000000001
100000000011000001110111011111111
11110111111111011100000010001
11110111111111011101010010001
11000000110101011100001010001
10000000000000001100000010001
10000000000000001101010000001
11000001110101011101011110001
11110111 1110101 1W1111000001
11111111 1111111 111111111111